11111111111
00000000000
00000000000
22222222222
22222222222